##########|##########
#.$.$.$.$#|#.$$..#.$#
#$..@....#|#r#....$$#
#.......$#|#....#.$$#
#$.$.$.$x#|#.......xL
##########|####U#####
----------|----------
##########|##########
#RbL.#..$#|#g$.#.$..#
#$..$$..##|#........#
#UD..$$..L|#......Rx#
#Lx....$.#|#$.#..$.##
##########|##########
----------|----------